111111111111111
110000P011011E1
100000000000001
100000011000001
100000000000001
1PC000000000001
111111111111111
