1111111111111111111111111111
1P00000000000000000000000001
1000000110000011111000000001
1000001100000110011000000001
1000011001000000110000000001
1000110001000001100000000001
1001111111100011000000000001
1000000001000111111100000001
1E000000000000000000000000C1
1111111111111111111111111111